NO ./textures/nord.xpm
SO ./textures/sud.xpm
EA ./textures/est.xpm
WE ./textures/ouest.xpm
F 250, 100,0
C 225,255,0

111111111
100000001
10E000001
100010001
100110001
100000001
100000001
111111111
