NO ./textures/grass_n.xpm
SO ./textures/grass_s.xpm
EA ./textures/grass_e.xpm
WE ./textures/grass_w.xpm
F 4, 39,16
C 126,215,204


 11111111
1000001111
1000000001   1111
10000000N1   1111
1000000001   11111
1000000001
1000000001      11111
1000000001111111000001
111111110000000001111
        111111111
