NO ./textures/north
SO ./textures/south
EA ./textures/east
WE ./textures/west
F 250, 100,0
C 225,255,0

1111111111111
1N10000000001
1100000011001
1000000000001
1010000000001
1000011110001
1000000000001
1111111111111