NO ./textures/nord.xpm
SO ./textures/sud.xpm
EA ./textures/est.xpm
WE ./textures/ouest.xpm
F 4, 39,16
C 126,215,204

111111111
100000001
10011000111
100000000001
1000N000111
111111111
