NO ./textures/north
SO ./textures/south
EA ./textures/east
WE ./textures/west
F 250, 100,0
C 225,255,0

111111
100001
10S101
100001
111111
