NO ./textures/nord.xpm
SO ./textures/sud.xpm
EA ./textures/est.xpm
WE ./textures/ouest.xpm
F 4, 39,16
C 126,215,204



111111111
10N0000001
100011111
11111
