NO ./textures/north
SO ./textures/south
EA ./textures/east
WE ./textures/west
F 250, 100,0
C 225,255,0

111111111
100000001
10N100001
100000001
100000001
100000001
100000001
111111111
